11111111111111111111111
10010030000000003001001
11000105011011050100011
10000001000500010000001
10501111110001111110501
11000000000100000000011
10000000110501100000001
10011000000100000011001
11500001100000110000511
11030010000100001003011
10001000110501100010001
15101000010001000010151
10000011000000011000001
11000000000400000000011
10000000110501100000001
10011100000000000111001
15000001100000110000051
11111111111111111111111
