11111111111111111111
10000000000000000001
10003000030000300001
10003000000000300001
10000001111100000001
10000001222100000001
10000001222100000001
10000001222100000001
10000001222100000001
10000001222100000001
10000001111100000001
10000000000000000001
10000000040000000001
11111111111111111111