1111111111111111111
1000000000000000001
1000000000000000001
1000000000000000001
1000000111110000001
1000000122210000001
1000000122210000001
1000000122210000001
1000000122210000001
1000000111110000001
1000000000000000001
1000000000000000001
1000000000000000001
1111111111111111111