11111111111111111111111111111111111111111111111
10000000000000000000000100000000000000000000001
10001111110001111110000100001111110001111110001
10011222210511222210000100001222211051222211001
10001111110001111110000100001111110001111110001
10000000000000000000000000000000000000000000001
10000001111111100010000000011111111100000010001
10011111222222100011030111112222222100030110001
10000001111111100010000000011111111100000010001
10000000000000000000000100000000000000000000001
10001111110001111110000100001111110001111110001
10001222211051222211000100011222210511222210001
10001111110001111110000100001111110001111110001
10000000000000000000000000000000000000000000001
10000001111111100010000000011111111100000010001
10011111222222103011000111112222222100030110001
10000001111111100010000000011111111100000010001
10000000000000000000000100000000000000000000001
10001111110001111110000100001111110001111110001
10011222210511222210000100001222211051222211001
10001111110001111110000100001111110001111110001
10000000000000000000000000000000000000000000001
10000001111111100010000000011111111100000010001
10011111222222100011001111112222222100000110001
10000001111111100010000000011111111100000010001
10000000000000000000000100000000000000000000001
10001111110001111110000100001111110001111110001
10001222211051222211000100011222210511222210001
10001111110001111110000100001111110001111110001
10000000000000000000000400000000000000000000001
11111111111111111111111111111111111111111111111
